Легенда футбола Пеле перенес операцию в больнице Сан-Паулу	neutral
Пеле перенес очередную операцию	neutral
В домах более 55 тысяч ветеранов накануне Дня Победы провели ремонт	positive
Власти отремонтировали 55 тысяч домов ветеранов ВОВ	neutral
МЭР: Россия подала в ВТО иск к Украине по пошлинам на нитрат аммония	negative
Россия подала в ВТО два новых иска к ЕС и Украине	neutral
Посол РФ в Латвии вызван в МИД республики в связи с интервью в газете	positive
МИД Латвии оспорил выводы посла РФ в интервью местной газете	negative
Авиаперевозчики отменяют утренние рейсы в Рим из-за пожара в аэропорту	negative
В результате пожара в римском аэропорту отменены два рейса в Россию	negative
После отравления на пикнике в США 18 человек были госпитализированы	negative
Пикник в США обернулся гибелью одного и госпитализацией 18 человек	negative
СМИ: суд в Каире подтвердил смертные приговоры 22 радикалам	negative
Суд Каира приговорил 22 сторонников "Братьев-мусульман" к смертной казни	negative
Менеджер Шумахера запретила СМИ публиковать новости о его здоровье	negative
Менеджер Шумахера запретила распространять информацию о здоровье гонщика	negative
Представители ДНР и Украины договорились на счет поиска тел погибших	positive
Представители ДНР и Украины три дня будут вместе искать погибших	negative
МЧС отправит в Донбасс 25-ю колонну с подарками для ветеранов	positive
Ко Дню Победы на Донбасс отправят подарки ветеранам	positive
Медведев поблагодарил региональные власти за помощь Крыму, Севастополю	positive
Медведев поблагодарил чиновников за восстановление соцсферы Крыма	positive
Иванов о танце студенток перед мемориалом: место выбрано неэтично	positive
Сергей Иванов прокомментировал танец на фоне мемориала в Новороссийске	neutral
Дацюк и Ковальчук примут участие в Матче звезд КХЛ.	neutral
Ковальчук стал капитаном сборной Запада в Матче звезд КХЛ.	neutral
Чиновников обяжут сдавать дорогие подарки государству.	negative
Российских чиновников обяжут отчитываться за полученные подарки.	negative
Волейболисты сборной России в третий раз выиграли Мировую лигу.	positive
Сборная России по волейболу выиграла Мировую лигу.	positive
Товарный поезд сошел с рельсов на мосту в Канаде, пострадавших нет.	neutral
В Канаде товарный поезд сошел с рельсов	neutral
Футболисты "Рубина" обыграли "Урал" в домашнем матче чемпионата России	positive
"Рубин" обыграл "Урал" и вышел на четвертое место	positive
Путин: Россия не пожалеет усилий для развития спорта в стране и в мире	positive
Путин пообещал поддержать спорт в стране и в мире	positive
Переведенный на армянский язык Коран впервые издан в Турции	positive
В Турции издали Коран на армянском	neutral
Армия Йемена заявила о поддержке президента страны	positive
У президента Йемена появилась поддержка в армии	positive
